1111111111111111111111111111111111111111
1000000000000000000000000000000000000001
1000000000000000000000000000000000000001
100P00000C0000000000000000000000000000C1
100111111100000000000000C000C00000111111
1000C00000000000000000001111100000000001
1000000C00MCM0000000000000000M0000000001
1001111111111000000000000000011111100001
1000000000000000000000000000000000000001
10000000000000E0000000000000000000000001
1111111111111111111111111111111111111111
